NO      textures/wall1.xpm
WE      textures/wall1.xpm
SO      textures/wall1.xpm
EA      textures/wall1.xpm

F    142,142,142
C    63,92,125

111111
100101
101001
1100N1
111111