NO      textures/wall1.xpm
WE      textures/wall2.xpm
SO      textures/wall3.xpm
EA      textures/wall4.xpm

F    40,33,33
C    63,92,125


        1111111111 11111111111111
        1000000001110000000000001
        1011000001110000000000001
        1001000000000000000000001
111111111011000001110000000000001
100000000011000001110111111111111
11110111111111011100000010001
1111011111111101110101001000111111111111111111111111111111111111111111111111
1E00000000000000000000000000000000000000000000000000000000000000000000000001
1100000000000000110101001000111111111111111111111111111111111111111111111111
 100000111010101111101111000111
11110111 1110101 101111010001
11111111 1111111 111111111111


