NO      textures/wall1.xpm
WE      textures/wall2.xpm
SO      textures/wall3.xpm
EA      textures/wall4.xpm

F    142,142,142
C    63,92,125


111111111111
100000000001
100100000001
100000010001
100010000001
101000010001
100000000001
100000001001
100100000W01
100000010001
100000000001
111111111111

