NO      textures/gal1.xpm
WE      textures/gal2.xpm
SO      textures/gal1.xpm
EA      textures/gal2.xpm

F 	127,205,252
C 	60,59,95


111111111111
100000010001
100S00010001
100000010001
100000000001
100000000001
100000000001
100000000001
100000000001
100000000001
100001100001
111111111111
