NO      textures/wall1.xpm
WE      textures/wall2.xpm
SO      textures/wall3.xpm
EA      textures/wall4.xpm

F   127,   205,    252
C   60,59,95

111111111111
100000010001
100N00010001
100000010001
100000000001
100000000001
100000000001
100000000001
100000000001
100000000001
100001100001
111111111111
